
AAAAAAAAAAAAAAAAAAAAAAAAAA...............R........R.MMM...RM.MR....M....AAAAAAAAAAAAAAAAAAAAAAAAAAAAAAAAAAAAAAAAAAAAAAAAAAAAAAAAAAAAAAAAAAAAAAAAAAAAAAAAA.......AA.M.....M...FFF..FFF.FFFFFFFFFF...
AAAAAAAAAAAAAAAAAAAAAAAAAAAAAA.............R..R.R.M...R....AA..........AAAAAAAAAAAAAAAAAAAAAAAAAAAAAAAAAAAAAAAAAAA...AAAAAAAAAAAAAAAAAAAAAAAAAAAAAAAAAAAAAAAAAAAA........AAAAAA....FFFFF..FF.......
AAAAAAAAAAAAAAAAAAAAAAAAAAAAAAAAAAAAAAA...RMM...M.R.......AAAAAAA.AAAAAAAAAAAAAAAAAAAAAAAAAAAAAAA..AAA.............RA.AAAAAAAAAAAAAAAAAAAAAAAAAAAAAAAAAAAAAAAAAAAAAAAAAAAAAAAAAAM..F...FFFF........
AAAAAAAAAAAAAAAAAAAAAAAAAAAAAAAAAAAAAAA....R.M.R.........AA.RMM.AAAAAAAAAAAAAAAAAAAAAAAAAAAAAA................RRRR.F.A.AAAAAAAAAAAAAAAAAAAAAAAAAAAAAAAAAAAAAAAAAAAAAAAA..R.RRRR..FFFF.FFFF.....RRRM
AAAAAAAAAAAAAAAAAAAAAAAAAAAAAAAAAAAAAAAAAA....M.........AAARRR..AAAAAAAAAAAAAAAAAAA..AAAAAAA..R.R..RR1..R.R...F...F.R..AAAAAAAAAAAAAAAAAAAAAAAAAAAAAAAAAAAAAAA........AAA....FFFFFFFFFF.......R....
AAAAAAAAAAAAAAAAAAAAAAAAAAAAAAAAAAAAAAAAAAAA..R..M.M.AA..AR......AAAAAAAAAAAAAAAAA..R....AA.A......FF...............M..AAAAAAAAAAAAAAAAAAA..AAAAAAA..AAAAAA.....RRRRR.RAAA...FFFFFFF.FFFFF......R..
AAAAAAAAAAAAAAAAAAAAAAAAAAAAAAAAAAAAAAAAAAAAA..........AAAA........AAAAAAAAA..AAA...F..M.A...FF...F..AA.................AAAAAAAAAA....AAA.....AAA...R..AAA..RRM..........RRRMFFFFF.................
AAAAAAAAAAAAAAAAAAAAAAAAAAAAAAAAAAAAAAAAAAAAAAAAAAA...AAAAAAAAAAAAAAAAAAAAA....AA.AM.....A..R.F....AAAAA...F.............AAAAAAAA.....AAAR..R...RRR....AAA..R..........FFFFF.....................MM
AAAAAAAAAAAAAAAAAAAAAAAAAAAAAAAAAAAAAAAAAAAAAAAAAAAAAAAAAAAAAAAAAAAAAAAAAA.R..R.A.AAAAAAAAA.....AAAAAAAA.............F.A.AAAA.A...R.AAAAR..M...........AAAA........................................
AAAAAAAAAAAAAAAAAAAAAAAAAAAAAAAAAAAAAAAAAAAAAAAAAAAAAAAAAAAAA....A...AAAA.R.F.AAAAAA.....AAAAAAAAAAAAAA...............AAAAAA......M.AAA......A........AAAAAAAAAAAM.............A.R.................
AAAAAAAAAAAAAAAAAAAAAAAAAAAAAAAAAAAAAAAAAAAAAAAAAAAAAAAAAAAA.........AAA.R.FM.AAA......M..AAA.A.......AAA........AAAAAAAAAAA....R..AAAAAAAAAAAA......AAAAAAAAAAAA.............AAAA.................
AAAAAAAAAAAAAAAAAAAAAAAAAAAAAAAAAAAAAAAAAAAAAAAAAAAAAAAAAAAA.AMFF....AAA...F...AA..M......AAA....R.FF..AAAAAAAAAAAR.....AAAAAAAAAAAAAAAAAAAAAAAAAAAAAAAAAAAAAAAAAA.R........AAAAAAAAAAM..........RA
AAAAAAAAAAAAAAAAAAAAAAAAAAAAAAAAAAAAAAAAAAAAAAAAAAAAAAAAAAAAA......RAAA..R..F.R.AA......AAA.....FF..FFF.AAAAA........F...AAAAAAAAAAAAA.........AAAAAAAAAAAAAAA..AA........R.AAAAAAAAAAA..........AA
AAAAAAAAAAAAAAAAAAAAAAAAAAAAAAAAAAAAAAAAAAAAAAAAAAAAAAAAAAAAAA......AAAA........AAAAAAAAAA..............AAAA.R.......F...AAA..........F.FFFFF......AAAAAAAAAAAI2.AA.........AAAAAAAAAAAAAAAAA...AAR
AAAAAAAAAAAAAAAAAAAAAAAAAAAAAAAAAAAAAAAAAAAAAAAAAAAAAAAAAAAAAAAAAAAAAAAAA......AAAAAAAAAAAAAAA........RAAAAA...........AAAA.........................AAAAAAAA..R..AAR.....AAAAAAAAAAAAAAAAAAAAAAAAMM
AAAAAAAAAAAAAAAAAAAAAAAAAAAAAAAAAAAAAAAAAAAAAAAAAAAAAAAAAAAAAAAAAAAAAAAAAAAAAAAAAAAAAAAAAAAAAAA........AAAAAAAAAAAAAAAAAAAA...F....................R....AAAAA...AAAA.AAAAAAAAAAAAAAAAAAAAAAAAAAA.RM
AAAAAAAAAAAAAAAAAAAAAAAAAAAAAAAAAAAAAAAAAAAAAAAAAAAAAAAAAAAAAAAAAAAAAAAAAAAAAAAAAAAAAAAAAAAAAAAAAAAAAAAAAAAAAAAAAAAAAAAAAAAA..MF..........................AAAAAAAAAAAAAAAAAAAAAAAAAAAAAAAAAAAAAAA.M
AAAAAAAAAAAAAAAAAAAAAAAAAAAAAAAAAAAAAAAAAAAAAAAAAAAAAAAAAAAAAAAAAAAAAAAAAAAAAAAAAAAAAAAAAAAAAAAAAAAAAAAAAAAAAAAAAAAAAAAAAAAAA.......FF........................AAAAAAAAAAAAAAAAAAAAAAAAAAAAAAAAAA.R.
AAAAAAAAAAAAAAAAAAAAAAAAAAAAAAAAAAAAAAAAAAAAAAAAAAAAAAAAAAAAAAAAAAAAAAAAAAAAAAAAAAAAAAAAAAAAAAAAAAAAAAAAAAAAAAAAAAAAAAAAAAAAAA.......................R.....F..AAA.A..AAAAAAAAAAAAAAAAAAAAAAAAAAAA.A
AAAAAAAAAAAAAAAAAAAAAAAAAAAAAAAAAAAAAAAAAAAAAAAAAAAAAAAAAAAAAAAAAAAAAAAAAAAAAAAAAAAAAAAAAAAAAAAAAAAAAAAAAAAAAAAAAAAAAAAAAAAAAAAAAA...........AAAAAAAA.....F..AAA.......AAAAAAAAAAAA.......AAAAAAAAA
AAAAAAAAAAAAAAAAAAAAAAAAAAAAAAAAAAAAAAAAAAAAAAAAAAAAAAAAAAAAAAAAAAAAAAAAAAAAAAAAAAAAAAAAAAAAAAAAAAAAAA......AAA.A.........AAAAAAAAAAAAAAAAAAAA....AAAAA.....AAAA..MF.M..AA....AAAA.R..R.M.MAAR...AA
AAAAAAAAAAAAAAAAAAAAAAAAAAAAAAAAAAAAAAAAAAAAAAAAAAAAAAAAAAAAAAAAAAAAAAAAAAAAAAAAAAAAAAAAAAAAAAAA.A....R.FF.R.....FF.....F...A.AAAAAAAAAAAAAA....MA.AAAAA...AAAAA..M..R..AA.F.MAAAA....FFFFMAA..FF..
AAAAAAAAAAAAAAAAAAAAAAAAAAAAAAAAAAAAAAAAAAAAAAAAAAAAAAAAAAAAAAAAAAAAAAAAAAAAAAAAAAAAAAAAAAAA....R........FFF......FF...FFFFF.....AAAAAAAAAA.AMF.....AAAAAAAAAA......FM.AAAAAAAAAAM.....FFR.AA....F.
AAAAAAAAAAAAAAAAAAAAAAAAAAAAAAAAAAAAAAAAAAAAAAAAAAAAAAAAAAAAAAAAAAAAAAAAAAAAAAAAAAAAAAAAAAA..MFFF....0....F........FF.....FFFFF.R.AAAAAAAAA....RAA..AAAAAAAAA.R.FFFFF.AAAAAAA.............AAAA.....
AAAAAAAAAAAAAAAAAAAAAAAAAAAAAAAAAAAAAAAAAAAAAAAAAAAAAAAAAAAAAAAAAAAAAAAAAAAAAAAAAAAAAAAA....MF..................................F...A.AAAAAAA.A.....AAAAAAAAAA.AAAAA.AAAAAAAAAA.M..............M..A
AAAAAAAAAAAAAAAAAAAAAAAAAAAAAAAAAAAAAAAAAAAAAAAAAAAAAAAAAAAAAAAAAAAAAAAAAAAAAAAAAAAAAA..R........................F...............FFF...AAAAAAAA.R....AAAAAAAAAAAAAAAAAAAAAAAAAA.............M......
AAAAAAAAAAAAAAAAAAAAAAAAAAAAAAAAAAAAAAAAAAAAAAAAAAAAAAAAAAAAAAAAAAAAAAAAAAAAAAAAAAAAA..R............................F.............FFF...AAAAAA.R.....AAAAAAAAAAAAAAAAAAAAAAAAAAA...A....A.AAAAAAAAA
AAAAAAAAAAAAAAAAAAAAAAAAAAAAAAAAAAAAAAAAAAAAAAAAAAAAAAAAAAAAAAAAAAAAAAAAAAAAAAAAAAAA..R.................FF.F......F................FFF.R.........M..AAAAAAAAAAAAAAAAAAAAAAAAAAAAAAAAAAAAAAAAAAAAAAA
AAAAAAAAAAAAAAAAAAAAAAAAAAAAAAAAAAAAAAAAAAAAAAAAAAAAAAAAAAAAAAAAAAAAAAAAAAAAAAAAAAA.................RAAA.MF........................................AAAAAAAAAAAAAAAAAAAAAAAAAAAAAAAAAAAAAAAAAAAAAAAA
AAAAAAAAAAAAAAAAAAAAAAAAAAAAAAAAAAAAAAAAAAAAAAAAAAAAAAAAAAAAAAAAAAAAAAAAAAAAAAAAAAA.....F.......FFFF....AMF..F...............F.FF....FFFFFFFFFFFR.AAAAAAAAAAAAAAAAAAAAAAAAAAAAAAAAAAAAAAAAAAAAAAAAA